4 2 14 14 10 8 6 10 14 10 10 12 4 6 10 10 14 10 10 12 6 14 10 10 14 8 6 14 10 10 8 6 14 10 10 10 10 12 6 12 
3 12 1 3 14 10 11 8 5 6 10 9 7 11 8 6 9 6 12 5 1 5 4 6 9 6 9 5 6 10 10 9 3 10 12 6 12 3 9 1 
4 3 10 12 3 10 8 6 9 3 12 2 13 4 6 9 6 9 1 3 12 5 3 11 8 5 6 9 3 10 10 12 2 12 3 9 3 10 10 12 
7 8 6 9 6 10 10 9 6 8 3 12 3 9 3 12 5 6 14 8 5 5 6 10 10 9 3 14 10 14 8 3 12 7 14 10 10 12 6 13 
7 12 3 10 9 6 10 8 7 10 12 5 6 10 10 9 5 5 3 12 5 5 5 2 10 10 12 3 12 1 6 12 3 9 5 6 12 5 5 1 
1 3 10 14 10 9 6 10 9 6 9 5 5 6 12 2 11 11 8 3 13 5 3 10 12 6 11 8 5 6 9 3 10 10 9 5 5 5 3 12 
6 10 12 3 10 12 3 10 12 3 10 9 3 9 7 10 10 10 10 12 3 11 14 8 3 13 6 10 9 5 6 10 10 10 10 9 5 1 6 13 
5 2 15 10 10 9 6 10 9 6 14 10 10 12 3 12 6 12 4 5 2 10 9 6 10 9 5 6 10 9 5 6 10 10 14 10 9 6 9 1 
7 12 1 6 10 12 3 12 2 9 5 6 12 5 4 5 5 5 5 3 10 10 10 9 6 10 13 5 6 12 5 1 6 12 3 10 10 9 6 12 
1 3 12 5 4 3 12 5 6 10 9 5 3 9 7 11 9 3 11 10 12 6 10 10 13 2 9 7 9 1 3 12 5 3 12 6 10 10 9 5 
6 10 9 3 11 12 3 9 5 2 10 11 12 4 5 6 12 2 10 10 13 3 10 12 1 6 12 5 6 10 12 3 9 6 13 5 2 12 6 13 
7 10 12 6 10 9 2 10 13 6 12 4 5 7 9 5 3 10 10 12 1 6 12 5 6 9 3 13 3 12 5 6 12 5 5 3 10 13 5 5 
3 8 5 5 4 6 14 10 9 5 5 5 5 7 8 5 6 10 12 3 10 9 5 7 9 6 12 1 6 9 3 9 5 5 3 14 8 5 5 1 
6 10 13 5 3 9 3 10 10 13 5 7 9 1 6 9 7 12 1 6 14 8 5 5 6 13 3 10 9 2 14 8 5 5 2 9 6 9 3 12 
7 12 1 3 10 12 6 10 12 5 5 3 14 10 9 2 9 3 10 13 5 6 9 1 5 1 6 12 6 10 9 6 9 7 10 10 11 8 6 9 
5 5 6 14 8 5 5 4 5 5 5 4 5 6 10 10 10 10 12 1 7 11 10 10 9 6 9 5 5 6 10 9 2 9 6 10 10 12 3 12 
5 3 9 3 10 9 5 7 9 5 5 5 5 3 12 2 14 12 3 12 5 6 10 10 10 9 6 9 5 3 12 2 14 12 3 12 4 3 10 13 
5 6 12 6 12 6 13 5 2 9 5 5 3 12 3 12 5 5 6 9 1 3 12 6 10 8 3 12 3 10 11 10 9 3 10 9 7 10 12 5 
3 9 5 5 5 5 5 3 10 12 5 7 8 3 12 3 9 5 3 10 10 12 3 13 6 10 10 9 6 10 12 6 12 4 6 14 9 2 9 5 
6 10 9 5 3 9 3 12 2 15 9 3 10 14 9 6 12 3 12 6 12 3 12 5 3 10 10 10 9 4 3 9 5 3 9 3 10 12 6 9 
5 6 12 5 6 10 12 3 12 1 6 10 12 3 12 5 1 6 9 5 7 8 3 9 6 12 6 14 8 7 12 6 9 6 10 10 12 3 11 12 
5 1 7 9 3 12 3 12 5 6 9 4 3 12 5 7 12 5 4 5 3 10 10 14 9 5 1 7 12 5 5 3 10 9 6 12 5 6 12 1 
3 12 3 8 6 9 4 5 7 9 6 15 8 5 5 1 5 5 5 3 12 6 12 7 12 3 12 1 3 9 3 10 12 6 9 5 5 5 3 12 
6 9 6 10 9 6 11 9 3 10 9 1 6 13 3 10 9 5 7 8 5 5 5 1 5 6 9 6 12 6 10 12 7 9 6 9 3 9 6 9 
3 10 9 6 12 3 10 10 12 6 10 12 5 5 6 10 12 5 7 10 9 5 3 10 9 3 10 9 3 9 4 5 1 6 9 6 14 8 3 12 
6 8 6 9 7 10 10 12 3 9 6 9 5 1 3 12 3 9 5 6 12 3 10 12 4 6 14 10 10 10 13 3 12 7 10 9 5 6 10 13 
3 10 13 6 13 2 10 9 6 10 9 6 13 6 12 5 2 10 15 9 3 10 12 5 3 9 7 12 6 12 3 8 5 3 8 6 13 3 12 5 
6 12 5 5 1 6 10 10 9 6 10 9 3 9 5 3 10 12 1 6 12 2 9 3 10 12 5 5 5 3 10 12 3 12 6 9 5 6 9 5 
5 5 1 3 12 3 10 12 4 3 10 10 12 6 11 8 6 9 6 9 3 10 12 6 10 9 1 5 5 6 12 3 12 3 9 6 9 3 12 1 
5 3 10 12 3 14 8 5 7 10 10 8 5 3 12 6 11 10 9 6 12 2 13 3 12 6 10 9 5 5 7 8 7 10 8 3 10 12 3 12 
3 12 4 5 6 9 6 9 7 10 12 6 11 8 3 15 8 6 10 9 3 12 3 10 9 5 6 10 11 9 5 6 13 6 10 12 6 11 8 5 
6 9 5 5 5 6 9 4 3 12 5 3 12 6 12 1 6 9 6 10 8 5 6 8 6 11 9 6 10 12 1 5 1 3 12 3 9 6 10 13 
7 12 7 11 9 3 12 3 14 9 7 12 5 5 3 10 9 2 11 10 12 5 7 10 11 8 6 9 4 3 12 5 6 12 7 8 6 9 4 5 
5 5 1 6 10 12 3 12 3 8 5 1 5 3 10 12 6 10 10 10 13 5 3 10 8 6 9 6 9 6 9 3 9 3 9 6 9 6 13 5 
5 3 10 9 6 11 12 3 10 12 7 10 11 10 8 5 5 2 10 10 9 5 6 10 10 9 6 13 6 9 6 10 10 10 10 9 2 9 5 5 
5 2 10 12 3 12 1 6 10 9 1 6 12 6 12 5 7 10 10 10 12 5 7 12 6 10 9 1 5 6 9 6 12 2 14 14 14 10 9 5 
3 10 10 13 6 9 6 9 6 14 10 9 3 9 3 9 3 12 6 8 5 5 5 5 7 10 10 10 9 3 14 9 3 12 5 5 1 6 10 9 
2 14 12 5 3 12 3 12 1 7 12 6 14 8 6 10 10 11 9 6 13 5 1 5 3 10 12 2 14 12 3 12 6 9 5 3 12 5 2 12 
6 9 1 3 12 3 12 3 12 1 5 5 3 10 9 2 12 6 10 9 1 3 12 5 6 12 3 10 9 3 12 1 5 6 9 6 9 3 10 13 
3 10 10 10 11 8 3 10 11 10 9 3 10 10 10 10 9 3 10 10 10 10 11 9 1 3 10 10 10 10 11 10 9 3 8 3 10 10 10 9 
