4 6 14 12 2 14 12 6 10 12 
5 5 5 3 10 9 5 3 12 5 
5 5 3 10 10 12 3 10 9 5 
5 5 6 10 12 3 10 12 2 13 
5 5 5 4 3 10 12 7 12 1 
5 1 5 7 14 8 5 5 3 12 
3 12 5 5 3 10 9 3 8 5 
4 3 9 5 2 10 14 10 10 13 
5 6 10 9 6 12 3 12 6 9 
3 11 10 10 9 3 10 9 3 8 
