4 6 14 10 10 12 4 6 10 10 14 12 6 12 2 12 
5 5 3 12 6 9 3 11 10 8 5 3 9 3 12 5 
5 5 6 9 3 12 6 10 10 10 9 6 10 12 5 5 
5 1 5 2 12 3 9 6 10 10 10 9 4 3 9 5 
3 12 3 12 7 10 8 5 6 12 6 10 11 12 6 13 
4 3 10 9 3 10 12 5 5 5 3 10 12 3 9 5 
3 14 14 10 10 14 9 5 5 5 6 12 5 6 10 13 
6 9 1 6 12 5 6 9 5 3 9 3 9 5 4 5 
7 12 6 9 5 5 5 6 9 6 10 14 8 5 5 5 
5 3 9 6 9 1 5 5 6 9 4 5 6 9 5 5 
5 6 12 5 6 12 5 5 3 12 3 9 5 6 9 5 
3 9 5 5 5 3 9 3 10 9 6 12 5 7 10 9 
6 10 9 5 5 6 10 10 10 10 9 3 9 3 10 12 
3 10 12 3 9 3 10 10 10 12 6 8 6 14 8 5 
6 8 3 10 10 10 10 10 10 9 7 12 5 3 12 5 
3 10 10 10 10 10 10 10 10 10 9 3 11 8 3 9 
