2 10 12 4 4 14 12 4 
4 4 9 5 9 5 3 9 
5 3 12 3 12 5 12 12 
7 8 5 4 9 6 10 13 
5 4 9 6 12 5 12 1 
5 9 4 13 3 12 5 12 
5 6 10 9 4 9 6 13 
3 9 4 12 11 10 9 1 
