4 2 14 12 6 10 14 10 10 10 12 2 14 10 12 4 
3 12 5 3 11 8 3 12 6 12 5 6 9 4 5 5 
4 5 7 10 8 6 12 3 9 5 3 9 6 13 5 5 
7 9 5 6 12 5 3 12 6 9 2 14 9 5 3 13 
5 4 5 5 3 9 2 13 7 10 12 5 2 13 4 5 
5 3 9 7 12 6 12 5 5 4 5 7 12 3 13 5 
3 10 12 1 3 9 5 5 3 13 5 1 5 2 13 5 
6 8 3 10 12 6 9 5 2 9 3 12 7 12 5 5 
7 10 14 12 5 5 4 3 10 12 6 9 1 5 5 5 
5 6 9 5 5 5 5 6 10 9 5 6 14 9 1 5 
5 5 4 5 3 9 5 3 10 10 9 5 3 10 10 9 
5 5 3 11 10 10 9 6 10 14 8 5 2 14 12 4 
5 3 10 10 10 10 12 3 12 3 12 5 6 9 5 5 
5 6 10 10 14 8 7 8 3 12 5 3 9 6 9 5 
5 3 10 8 3 12 3 12 6 9 3 14 8 3 12 5 
3 10 10 10 10 11 8 3 11 10 8 3 10 10 11 9 
